Alice had got so much into the way of expecting nothing but but 	 Linenumber: 6
anxiously to herself Which way Which She ate a little bit and said 	 Linenumber: 2
ate a little bit and said anxiously to herself Which way Which She 	 Linenumber: 2
bit and said anxiously to herself Which way Which She ate a little 	 Linenumber: 2
cake size to be sure this is what generally happens when one eats 	 Linenumber: 5
cake So she set to work and very soon finished off the 	 Linenumber: 10
common way for life to go on in the 	 Linenumber: 8
dull and stupid outoftheway things to happen that it seemed quite 	 Linenumber: 7
eats cake size to be sure this is what generally happens when one 	 Linenumber: 5
expecting nothing but but Alice had got so much into the way of 	 Linenumber: 6
feel which way it was way holding her hand on the top of her head to 	 Linenumber: 3
find that she remained the same growing and she was quite surprised to 	 Linenumber: 4
finished off the cake So she set to work and very soon 	 Linenumber: 10
generally happens when one eats cake size to be sure this is what 	 Linenumber: 5
go on in the common way for life to 	 Linenumber: 8
got so much into the way of expecting nothing but but Alice had 	 Linenumber: 6
growing and she was quite surprised to find that she remained the same 	 Linenumber: 4
had got so much into the way of expecting nothing but but Alice 	 Linenumber: 6
hand on the top of her head to feel which way it was way holding her 	 Linenumber: 3
happens when one eats cake size to be sure this is what generally 	 Linenumber: 5
happen that it seemed quite dull and stupid outoftheway things to 	 Linenumber: 7
head to feel which way it was way holding her hand on the top of her 	 Linenumber: 3
her hand on the top of her head to feel which way it was way holding 	 Linenumber: 3
her head to feel which way it was way holding her hand on the top of 	 Linenumber: 3
herself Which way Which She ate a little bit and said anxiously to 	 Linenumber: 2
holding her hand on the top of her head to feel which way it was way 	 Linenumber: 3
life to go on in the common way for 	 Linenumber: 8
little bit and said anxiously to herself Which way Which She ate a 	 Linenumber: 2
much into the way of expecting nothing but but Alice had got so 	 Linenumber: 6
nothing but but Alice had got so much into the way of expecting 	 Linenumber: 6
off the cake So she set to work and very soon finished 	 Linenumber: 10
outoftheway things to happen that it seemed quite dull and stupid 	 Linenumber: 7
quite dull and stupid outoftheway things to happen that it seemed 	 Linenumber: 7
quite surprised to find that she remained the same growing and she was 	 Linenumber: 4
remained the same growing and she was quite surprised to find that she 	 Linenumber: 4
said anxiously to herself Which way Which She ate a little bit and 	 Linenumber: 2
same growing and she was quite surprised to find that she remained the 	 Linenumber: 4
seemed quite dull and stupid outoftheway things to happen that it 	 Linenumber: 7
set to work and very soon finished off the cake So she 	 Linenumber: 10
She ate a little bit and said anxiously to herself Which way Which 	 Linenumber: 2
she remained the same growing and she was quite surprised to find that 	 Linenumber: 4
she set to work and very soon finished off the cake So 	 Linenumber: 10
she was quite surprised to find that she remained the same growing and 	 Linenumber: 4
size to be sure this is what generally happens when one eats cake 	 Linenumber: 5
soon finished off the cake So she set to work and very 	 Linenumber: 10
So she set to work and very soon finished off the cake 	 Linenumber: 10
stupid outoftheway things to happen that it seemed quite dull and 	 Linenumber: 7
sure this is what generally happens when one eats cake size to be 	 Linenumber: 5
surprised to find that she remained the same growing and she was quite 	 Linenumber: 4
things to happen that it seemed quite dull and stupid outoftheway 	 Linenumber: 7
top of her head to feel which way it was way holding her hand on the 	 Linenumber: 3
very soon finished off the cake So she set to work and 	 Linenumber: 10
way for life to go on in the common 	 Linenumber: 8
way holding her hand on the top of her head to feel which way it was 	 Linenumber: 3
way it was way holding her hand on the top of her head to feel which 	 Linenumber: 3
way of expecting nothing but but Alice had got so much into the 	 Linenumber: 6
way Which She ate a little bit and said anxiously to herself Which 	 Linenumber: 2
Which She ate a little bit and said anxiously to herself Which way 	 Linenumber: 2
Which way Which She ate a little bit and said anxiously to herself 	 Linenumber: 2
work and very soon finished off the cake So she set to 	 Linenumber: 10
